10x10
#text.jpg;$text2.jpg;%text3.jpg
##########
#  %   % #
#  $ $ $ #
#        #
#        #
#  $   $ #
#  $   $ #
#        #
##########