27x27
444444444444444444444444444
444444444444444444444444444
444444444444444444444444444
444545555555455555455555444
444545444445454545444445444
444555455545454545554555444
444444444545454544454544444
444555455545454555454555444
444545454445454445454545444
444545554555454555454545444
444545444544444544454445444
444545455545555545454555444
444544454445444445454545444
444555554555455555454545444
444544444544444545454545444
444545555555554545554545444
444544444444454544444545444
444545555555454555555545444
444545444445454444444444444
444545455545454555455555444
444545444545454545454445444
444545455545455545555545444
444545454445444444444445444
444555455555555555555555444
444444444444444444444444444
444444444444444444444444444
444444444444444444444444444