23x23
44444444444444444444444
45455555554555554555554
45454444454545454444454
45554555454545455545554
44444445454545444545444
45554555454545554545554
45454544454544454545454
45455545554545554545454
45454445444445444544454
45454555455555454545554
45444544454444454545454
45555545554555554545454
45444445444445454545454
45455555555545455545454
45444444444545444445454
45455555554545555555454
45454444454544444444444
45454555454545554555554
45454445454545454544454
45454555454555455555454
45454544454444444444454
45554555555555555555554
44444444444444444444444