40x20
2222222222222222222222222222222222222222
2111111112211111111221111111122111111112
2110111112211011111221101111122110111112
2113111112211311111221131111122113111112
2111131112211113111221111311122111131112
2111111112211111111221111111122111111112
2131111112213111111221311111122131111112
2111113112211111311221111131122111113112
2111111112211111111221111111122111111112
2222222222222222222222222222222222222222
2222222222222222222222222222222222222222
2111111112211111111221111111122111111112
2110111112211011111221101111122110111112
2113111112211311111221131111122113111112
2111131112211113111221111311122111131112
2111111112211111111221111111122111111112
2131111112213111111221311111122131111112
2111113112211111311221111131122111113112
2111111112211111111221111111122111111112
2222222222222222222222222222222222222222