10x10
2222222222
2111111112
2110111112
2113111112
2111131112
2111111112
2131111112
2111113112
2111111112
2222222222